1111111111111111111111111111111111111111111111
1P000000000000000000C00C00C00C00C00C00C00C0001
1000000000000000000000000000000000000000000001
1000000000000000000000000000000000000000000001
1000000000000000000000000000000000000000000001
1000000000000000000000000000000000000000000001
1000000000000000000000000000000000000000000001
1000000000000000000000000000000000000000000001
1000000000000000000000000000000000000000000001
1000000000000000000000000000000000000000000001
1000000000000000000000000000000000000000000001
1000000000000000000000000000000000000000000001
1000000000000000000000000000000000000000000001
1000000000000000000000000000000000000000000001
1000000000000000000000000000000000000000000001
1000000000000000000000000000000000000000000001
1000000000000000000000000000000000000000000001
1000000000000000000000000000000000000000000001
1000000000000000000000000000000000000000000001
1000011111000000000000000000000000000000000001
1000000000000000000000000000000000000000000001
1000011111000000000000000000000000000000000001
1000000000000000000000000000000000000000000001
1000011111000000000000000000000000000000000001
1000000000000000000000000000000000000000000001
1000011111000000000000000000000000000000000001
1000000000000000000000000000000000000000000001
1000011111000000000000000000000000000000000001
1000000000000000000000000000000000000000000001
1000011111000000000000000000000000000000000001
1000000000000000000000000000000000000000000001
1000011111000000000000000000000000000000000001
1000000000000000000000000000000000000000000001
1000011111000000000000000000000000000000000001
1000000000000000000000000000000000000000000001
1000011111000000000000000000000000000000000001
1000000000000000000000000000000000000000000001
1000011111000000000000000000000000000000000001
1000000000000000000000000000000000000000000001
1000011111000000000000000000000000000000000001
1000000000000000000000000000000000000000000001
1000011111000000000000000000000000000000000001
1000000000000000000000000000000000000000000001
1000011111000000000000000000000000000000000001
1000000000000000000000000000000000000000000001
1000011111000000000000000000000000000000000001
1000000000000000000000000000000000000000000001
1000011111000000000000000000000000000000000001
1000000000000000000000000000000000000000000001
1000011111000000000000000000000000000000000001
1000000000000000000000000000000000000000000001
1000011111000000000000000000000000000000000001
1000000000000000000000000000000000000000000001
10000C0000000000000000000000000000000000000001
100000000000000000000000000000000000000000E001
1111111111111111111111111111111111111111111111
