111111111111
1000000000E1
101111111001
101P0CC01001
101111111001
100000000001
111111111111
