1111111111111
1P01000000C1
100001111001
1P0011E00001
111111111111
