11111
1P001
10001
1E0C1
11111
