111111111111
1001000000C1
100001111001
1P0011E10001
111111111111
