1111111111
1P010000C1
100E000001
1001000001
1111111111