1111111111
1P00A000C1
100E000001
1000000001
1111111111