1111111111
1P010000E1
100C000001
1001000001
1111111111