1111111111
1P01000CE1
1000000CC1
1001000CC1
1111111111