1111111
1P001E1
1C11111
1111111

